shirley vanwagoner : love the challenge. so fun too. great game to play too pass time
carrie cooke : such a good game can wait for the update
julie montoya : love the cats
dd bb : cool!
rosiegene butler : great game
lynn crago : it is fun
tina marie dinolfi : cool
stephen bacheldor : great game!
anthony grisanti : great game!
randal alford : was fun!
susan harper : love this!
angel webb : absolutely adorable!
aimee ng : loved it!
gudrun schwartz : im learning.
penny wadoux : relaxing game :-)
yeo' handyman : thot provoking
colleen wolf : great game
renae batten : such fun
ggamergetch : awsome game
jean parker : fun addicting
sean rood : cool
lana golubeva : very cule!
dander : boring
hazy naoki : refil battery.
carlen cocoa : cool
moises gonzalez : cats meow
peraveen kumar : great game
kristina korpar : great game
cho lay : i jerrry loving this game because i 12 year old and the game have so much fun!!! 5 star
she post : interesting
kate bowen : lived it.
april wilson : aprilwilson
